12,12,12,12,12,12,12,12,12,12,12,12,12,12,12,12,12,12,12,12,12,12,12,12,12,12,12,12,12,12,12,12,12,12,12,12,12,12,12,
12,06,06,06,01,01,01,00,00,00,00,00,05,00,00,00,00,00,11,11,11,11,11,11,11,11,11,11,00,00,00,00,00,00,00,00,00,00,12,
12,06,06,06,01,01,01,01,01,01,01,01,01,01,01,01,01,01,01,01,01,01,01,01,01,01,01,01,01,01,01,01,01,01,01,08,00,00,12,
12,00,00,00,01,08,09,09,09,11,17,17,17,17,17,17,17,17,17,17,17,17,17,17,17,17,17,17,17,17,17,17,17,17,17,08,00,00,12,
12,00,13,00,01,08,10,10,10,00,17,17,17,17,17,17,17,17,17,17,07,07,07,07,07,07,07,07,07,07,07,07,07,07,07,07,00,00,12,
12,00,13,00,01,08,11,11,11,11,17,00,05,00,00,00,16,00,17,17,08,00,14,15,15,15,15,15,15,15,15,15,15,15,11,11,11,00,12,
12,00,00,00,01,01,17,08,07,04,05,11,05,00,00,00,16,04,17,17,08,03,16,03,05,03,04,00,00,06,00,00,00,00,00,00,00,00,12,
12,00,00,00,01,01,17,08,16,15,15,15,15,15,15,15,15,03,17,17,08,00,16,00,00,00,00,03,00,03,11,00,00,00,00,11,00,00,12,
12,03,04,00,07,01,17,08,16,11,11,11,11,00,11,11,11,11,17,17,08,11,16,00,00,00,00,00,00,00,00,00,00,00,00,00,00,00,12,
12,03,04,00,00,01,17,08,16,11,01,01,01,01,01,01,01,01,17,17,01,01,01,08,00,00,05,00,00,00,00,00,00,00,00,00,00,00,12,
12,00,00,00,00,01,17,08,16,11,17,17,17,17,17,17,17,17,17,17,17,17,17,08,00,00,00,03,00,03,03,00,00,00,00,00,11,00,12,
12,11,11,11,11,01,17,08,16,11,17,17,08,07,07,07,07,07,07,07,11,17,17,08,00,00,00,09,09,09,09,13,00,11,00,00,00,00,12,
12,01,01,01,01,01,01,01,01,01,17,17,08,14,14,15,15,15,15,15,11,17,17,08,06,00,04,10,10,10,10,00,00,00,00,00,00,00,12,
12,17,17,17,17,17,17,17,17,17,17,17,08,16,11,11,00,11,04,16,11,17,17,08,00,00,03,01,01,01,01,08,00,00,00,00,00,00,12,
12,07,07,07,07,17,01,07,07,07,07,07,11,16,03,11,00,03,04,16,11,17,17,08,00,00,04,11,11,11,11,03,00,00,00,11,00,00,12,
12,11,11,11,11,17,01,03,11,03,11,11,05,16,03,11,00,11,05,16,03,17,17,08,00,00,11,03,04,03,04,04,00,00,00,00,00,00,12,
12,00,00,00,00,17,01,03,15,15,15,15,15,15,00,11,00,00,00,16,11,17,17,08,14,15,15,15,15,15,15,15,15,15,00,00,00,00,12,
12,00,00,00,11,17,01,00,14,00,00,00,00,00,00,11,00,11,05,16,05,17,17,01,01,01,01,01,01,01,01,01,01,08,00,11,00,00,12,
12,00,11,00,00,17,01,11,14,00,00,00,11,03,00,11,00,00,00,16,11,17,17,17,17,17,17,17,17,17,17,17,17,08,00,00,00,00,12,
12,00,00,11,00,17,01,00,00,13,00,00,00,00,00,11,00,00,13,05,05,07,07,07,07,07,07,07,07,07,07,07,07,00,00,11,00,11,12,
12,00,00,00,00,17,01,00,03,00,00,00,11,00,00,11,11,00,00,00,00,11,00,11,00,00,00,00,11,00,11,00,00,00,11,00,00,00,12,
12,00,00,00,00,07,07,00,00,00,00,00,00,00,00,11,11,00,05,00,00,00,00,00,00,00,00,00,11,11,00,00,00,00,00,00,11,00,12,
12,12,12,12,12,12,12,12,12,12,12,12,12,12,12,12,12,12,12,12,12,12,12,12,12,12,12,12,12,12,12,12,12,12,12,12,12,12,12,

2,2,2,2,2,2,2,2,2,2,2,2,2,2,2,2,2,2,2,2,2,2,2,2,2,2,2,2,2,2,2,2,2,2,2,2,2,2,2,
2,0,0,0,0,0,0,0,0,0,0,0,0,0,0,0,0,0,0,0,0,0,0,0,0,0,0,0,0,0,0,0,0,0,0,0,0,0,2,
2,0,0,0,0,0,0,0,0,0,0,0,0,0,0,0,0,0,0,0,0,0,0,0,0,0,0,0,0,0,0,0,0,0,0,0,0,0,2,
2,0,0,0,0,0,2,2,2,0,0,0,0,0,0,0,0,0,0,0,0,0,0,0,0,0,0,0,0,0,0,0,0,0,0,0,0,0,2,
2,0,2,0,0,0,2,2,2,0,0,0,0,0,0,0,0,0,0,0,0,0,0,0,0,0,0,0,0,0,0,0,0,0,0,0,0,0,2,
2,0,2,0,0,0,0,0,0,0,0,0,0,0,0,0,2,0,0,0,0,0,2,2,2,2,2,2,2,2,2,2,2,2,0,0,0,0,2,
2,0,0,0,0,0,0,0,0,0,0,0,0,0,0,0,2,0,0,0,0,0,2,0,0,0,0,0,0,0,0,0,0,0,0,0,0,0,2,
2,0,0,0,0,0,0,0,2,2,2,2,2,2,2,2,2,0,0,0,0,0,2,0,0,0,0,0,0,0,0,0,0,0,0,0,0,0,2,
2,0,0,0,0,0,0,0,2,0,0,0,0,0,0,0,0,0,0,0,0,0,2,0,0,0,0,0,0,0,0,0,0,0,0,0,0,0,2,
2,0,0,0,0,0,0,0,2,0,0,0,0,0,0,0,0,0,0,0,0,0,0,0,0,0,0,0,0,0,0,0,0,0,0,0,0,0,2,
2,0,0,0,0,0,0,0,2,0,0,0,0,0,0,0,0,0,0,0,0,0,0,0,0,0,0,0,0,0,0,0,0,0,0,0,0,0,2,
2,0,0,0,0,0,0,0,2,0,0,0,0,0,0,0,0,0,0,0,0,0,0,0,0,0,0,2,2,2,2,2,0,0,0,0,0,0,2,
2,0,0,0,0,0,0,0,0,0,0,0,0,2,2,2,2,2,2,2,0,0,0,0,0,0,0,2,2,2,2,0,0,0,0,0,0,0,2,
2,0,0,0,0,0,0,0,0,0,0,0,0,2,0,0,0,0,0,2,0,0,0,0,0,0,0,0,0,0,0,0,0,0,0,0,0,0,2,
2,0,0,0,0,0,0,0,0,0,0,0,0,2,0,0,0,0,0,2,0,0,0,0,0,0,0,0,0,0,0,0,0,0,0,0,0,0,2,
2,0,0,0,0,0,0,0,0,0,0,0,0,2,0,0,0,0,0,2,0,0,0,0,0,0,0,0,0,0,0,0,0,0,0,0,0,0,2,
2,0,0,0,0,0,0,0,2,2,2,2,2,2,0,0,0,0,0,2,0,0,0,0,2,2,2,2,2,2,2,2,2,2,0,0,0,0,2,
2,0,0,0,0,0,0,0,2,0,0,0,0,0,0,0,0,0,0,2,0,0,0,0,0,0,0,0,0,0,0,0,0,0,0,0,0,0,2,
2,0,0,0,0,0,0,0,2,0,0,0,0,0,0,0,0,0,0,2,0,0,0,0,0,0,0,0,0,0,0,0,0,0,0,0,0,0,2,
2,0,0,0,0,0,0,0,0,2,0,0,0,0,0,0,0,0,2,0,0,0,0,0,0,0,0,0,0,0,0,0,0,0,0,0,0,0,2,
2,0,0,0,0,0,0,0,0,0,0,0,0,0,0,0,0,0,0,0,0,0,0,0,0,0,0,0,0,0,0,0,0,0,0,0,0,0,2,
2,0,0,0,0,0,0,0,0,0,0,0,0,0,0,0,0,0,0,0,0,0,0,0,0,0,0,0,0,0,0,0,0,0,0,0,0,0,2,
2,2,2,2,2,2,2,2,2,2,2,2,2,2,2,2,2,2,2,2,2,2,2,2,2,2,2,2,2,2,2,2,2,2,2,2,2,2,2,

