00,00,00,00,00,00,00,00,00,00,00,00,00,00,00,00,00,00,00,00,00,00,00,00,00,00,00,00,00,00,00,00,00,00,00,00,00,00,00,
12,00,13,13,00,00,13,13,00,00,13,13,00,00,00,00,00,00,11,00,00,00,00,17,17,17,17,17,17,17,17,17,17,17,17,17,17,17,12,
12,00,13,13,00,00,13,13,00,00,13,13,00,00,13,00,00,00,00,00,00,00,00,17,17,17,17,17,17,17,17,17,17,01,01,01,01,17,12,
12,01,17,01,17,01,01,17,17,01,17,17,01,01,17,17,01,17,01,17,01,17,01,17,01,01,17,17,08,03,03,00,00,17,01,17,01,01,12,
12,00,17,17,17,17,17,17,17,17,17,17,01,17,01,17,01,01,17,01,01,17,17,01,17,17,01,17,08,09,09,09,00,17,01,17,17,01,12,
12,07,07,07,07,07,07,07,07,07,07,01,01,17,17,17,17,01,01,01,01,17,17,17,13,13,00,00,00,10,10,10,00,17,01,17,17,01,12,
12,15,15,15,14,14,14,15,15,15,16,01,01,01,08,11,11,09,09,03,17,17,00,00,13,13,00,00,16,01,17,01,01,17,17,17,17,01,12,
12,05,05,04,03,05,05,04,03,05,16,17,17,01,08,00,03,10,10,03,17,17,00,00,00,00,00,03,16,17,17,17,01,17,17,17,17,01,12,
12,00,04,04,03,04,03,05,05,05,16,17,17,01,08,03,03,03,03,03,17,17,03,11,03,03,03,03,16,17,17,01,17,01,17,17,01,17,12,
12,11,11,11,11,11,11,11,11,05,16,17,01,01,08,15,15,15,15,15,15,15,15,15,15,15,15,15,15,17,17,01,17,17,17,17,17,17,12,
12,11,17,17,17,17,01,17,17,17,17,17,17,17,17,17,17,17,01,17,17,17,01,17,01,17,17,17,17,17,17,17,01,17,17,17,17,17,12,
12,11,01,17,17,01,17,17,17,17,17,17,17,01,01,17,17,17,01,17,17,01,17,17,01,17,17,17,17,01,17,01,01,17,17,17,01,01,12,
12,11,17,17,01,07,07,07,07,17,17,07,07,07,07,07,07,17,17,07,07,07,07,07,01,01,17,01,01,00,00,00,13,13,13,13,13,00,12,
12,11,17,01,01,11,03,13,11,17,17,11,05,03,03,05,11,17,17,11,03,03,03,11,07,17,01,17,01,01,00,00,13,13,13,13,13,00,12,
12,11,01,01,01,11,05,13,11,17,17,11,13,13,03,05,11,17,17,11,05,05,03,03,13,07,17,17,17,01,01,00,13,13,13,13,13,00,12,
12,11,17,17,01,11,05,05,11,17,17,11,05,03,03,03,11,17,17,11,05,05,03,05,13,16,07,17,17,17,01,01,13,13,13,13,13,00,12,
12,11,01,01,01,15,15,15,15,15,15,15,15,15,15,15,15,15,15,15,15,15,15,15,15,15,16,01,17,17,01,01,01,13,13,13,13,00,12,
12,11,01,01,17,17,01,17,17,17,17,17,17,17,17,17,17,17,17,17,17,01,17,17,17,01,16,16,16,16,01,17,01,01,01,13,13,00,12,
12,11,01,01,17,17,01,17,17,17,17,17,01,17,17,17,17,17,01,17,17,01,17,17,17,01,01,01,01,16,16,01,01,17,01,08,13,00,12,
12,11,17,17,17,17,17,17,17,17,17,17,17,17,17,17,17,17,17,17,17,17,17,17,17,17,01,01,01,01,16,16,01,01,01,17,17,01,12,
12,11,07,07,07,07,07,07,07,07,07,07,07,07,07,07,07,07,07,07,07,07,07,07,07,07,07,07,07,07,00,16,01,17,01,01,01,01,12,
12,00,00,00,00,13,00,00,00,00,00,00,00,00,00,00,00,13,00,00,00,00,00,00,13,00,00,00,00,00,00,16,01,01,01,13,01,01,12,
12,12,12,12,12,12,12,12,12,12,12,12,12,12,12,12,12,12,12,12,12,12,12,12,12,12,12,12,12,12,12,12,12,12,12,12,12,12,12,

2,0,0,0,0,0,0,0,0,0,0,0,0,0,0,0,0,0,0,0,0,0,0,0,0,0,0,0,0,0,0,0,0,0,0,0,0,0,2,
2,0,2,2,0,0,2,2,0,0,2,2,0,0,0,0,0,0,0,0,0,0,0,0,0,0,0,0,0,0,0,0,0,0,0,0,0,0,2,
2,0,2,2,0,0,2,2,0,0,2,2,0,0,2,0,0,0,0,0,0,0,0,0,0,0,0,0,0,0,0,0,0,0,0,0,0,0,2,
2,0,0,0,0,0,0,0,0,0,0,0,0,0,0,0,0,0,0,0,0,0,0,0,0,0,0,0,0,0,0,0,0,0,0,0,0,0,2,
2,0,0,0,0,0,0,0,0,0,0,0,0,0,0,0,0,0,0,0,0,0,0,0,0,0,0,0,0,2,2,2,0,0,0,0,0,0,2,
2,0,0,0,0,0,0,0,0,0,0,0,0,0,0,0,0,0,0,0,0,0,0,0,2,2,0,0,0,2,2,2,0,0,0,0,0,0,2,
2,2,2,2,2,2,2,2,2,2,2,0,0,0,0,0,0,2,2,0,0,0,0,0,2,2,0,0,2,0,0,0,0,0,0,0,0,0,2,
2,0,0,0,0,0,0,0,0,0,2,0,0,0,0,0,0,2,2,0,0,0,0,0,0,0,0,0,2,0,0,0,0,0,0,0,0,0,2,
2,0,0,0,0,0,0,0,0,0,2,0,0,0,0,0,0,0,0,0,0,0,0,0,0,0,0,0,2,0,0,0,0,0,0,0,0,0,2,
2,0,0,0,0,0,0,0,0,0,2,0,0,0,0,2,2,2,2,2,2,2,2,2,2,2,2,2,2,0,0,0,0,0,0,0,0,0,2,
2,0,0,0,0,0,0,0,0,0,0,0,0,0,0,0,0,0,0,0,0,0,0,0,0,0,0,0,0,0,0,0,0,0,0,0,0,0,2,
2,0,0,0,0,0,0,0,0,0,0,0,0,0,0,0,0,0,0,0,0,0,0,0,0,0,0,0,0,0,0,0,0,0,0,0,0,0,2,
2,0,0,0,0,0,0,0,0,0,0,0,0,0,0,0,0,0,0,0,0,0,0,0,0,0,0,0,0,0,0,0,2,2,2,2,2,0,2,
2,0,0,0,0,0,0,2,0,0,0,0,0,0,0,0,0,0,0,0,0,0,0,0,0,0,0,0,0,0,0,0,2,2,2,2,2,0,2,
2,0,0,0,0,0,0,2,0,0,0,0,2,2,0,0,0,0,0,0,0,0,0,0,2,0,0,0,0,0,0,0,2,2,2,2,2,0,2,
2,0,0,0,0,0,0,0,0,0,0,0,0,0,0,0,0,0,0,0,0,0,0,0,2,2,0,0,0,0,0,0,2,2,2,2,2,0,2,
2,0,0,0,0,2,2,2,2,2,2,2,2,2,2,2,2,2,2,2,2,2,2,2,2,2,2,0,0,0,0,0,0,2,2,2,2,0,2,
2,0,0,0,0,0,0,0,0,0,0,0,0,0,0,0,0,0,0,0,0,0,0,0,0,0,2,2,2,2,0,0,0,0,0,2,2,0,2,
2,0,0,0,0,0,0,0,0,0,0,0,0,0,0,0,0,0,0,0,0,0,0,0,0,0,0,0,0,2,2,0,0,0,0,0,2,0,2,
2,0,0,0,0,0,0,0,0,0,0,0,0,0,0,0,0,0,0,0,0,0,0,0,0,0,0,0,0,0,2,2,0,0,0,0,0,0,2,
2,0,0,0,0,0,0,0,0,0,0,0,0,0,0,0,0,0,0,0,0,0,0,0,0,0,0,0,0,0,0,2,0,0,0,0,0,0,2,
2,0,0,0,0,2,0,0,0,0,0,0,0,0,0,0,0,2,0,0,0,0,0,0,2,0,0,0,0,0,0,2,0,0,0,2,0,0,2,
2,2,2,2,2,2,2,2,2,2,2,2,2,2,2,2,2,2,2,2,2,2,2,2,2,2,2,2,2,2,2,2,2,2,2,2,2,2,2,
