14,15,15,15,15,15,15,15,15,15,15,15,15,15,15,15,15,15,15,15,15,15,15,15,15,15,15,15,15,15,15,15,15,15,15,15,15,15,15,
16,03,05,03,05,05,03,05,03,05,05,03,03,05,03,05,03,05,03,13,13,04,04,04,06,04,04,06,06,06,06,06,06,06,06,06,06,06,16,
16,03,03,03,05,03,05,03,03,05,05,05,05,03,03,03,05,03,05,13,13,04,06,06,04,06,06,04,06,04,04,06,06,06,06,06,06,06,16,
16,13,17,01,17,01,01,17,17,01,13,17,01,01,17,17,01,17,01,17,01,17,01,17,01,01,17,13,11,11,11,11,11,17,01,17,01,13,16,
16,00,17,17,17,17,17,17,17,17,17,17,01,17,01,17,01,01,17,01,01,17,17,01,17,17,01,17,11,09,09,09,11,17,01,17,17,01,16,
16,07,17,17,17,07,07,07,07,07,01,01,01,17,17,17,17,01,01,01,01,17,17,17,01,01,01,17,11,10,10,10,11,17,01,17,17,01,16,
16,03,01,17,01,08,00,00,00,00,01,17,08,07,07,07,07,01,01,01,17,08,07,07,07,17,01,01,11,11,11,11,11,00,17,17,17,01,16,
16,05,01,17,01,08,16,15,15,00,01,17,08,16,16,16,00,01,01,01,17,08,00,16,00,17,01,01,01,00,16,16,16,00,17,17,17,01,16,
16,00,17,17,01,08,16,09,09,00,01,17,08,16,06,06,00,01,01,01,17,08,16,11,16,00,01,01,01,00,16,03,16,00,17,17,01,17,16,
16,11,01,17,17,08,16,10,10,00,01,17,08,16,09,09,00,01,01,01,01,08,16,11,16,00,01,01,01,00,16,05,16,00,17,17,17,17,16,
16,11,17,01,17,08,16,13,03,00,01,17,08,16,10,10,00,17,01,17,17,08,16,11,16,00,01,01,17,00,14,03,15,00,17,17,17,17,16,
16,11,01,17,17,08,14,15,15,00,01,17,08,14,15,15,00,17,01,17,17,08,14,15,15,00,17,17,17,00,14,15,13,00,17,17,01,01,16,
16,11,17,17,01,08,16,09,09,00,01,17,08,16,06,04,00,17,17,01,01,08,16,11,16,00,17,01,01,00,16,05,16,00,17,17,17,17,16,
16,11,17,01,01,08,16,10,10,00,01,17,08,16,04,06,00,17,17,01,01,08,16,13,16,00,01,17,01,00,16,03,16,00,17,17,17,17,16,
16,11,01,01,01,08,16,09,09,00,01,17,08,16,06,04,00,17,17,01,01,08,16,13,16,00,17,17,17,00,16,05,16,00,17,17,17,17,16,
16,11,17,17,01,08,16,10,10,00,01,17,08,16,04,06,00,17,17,01,01,08,16,11,16,00,17,17,17,00,16,05,16,00,17,17,17,17,16,
16,11,01,01,01,08,14,13,03,00,01,17,08,14,15,15,00,01,01,01,01,08,16,11,16,00,17,01,17,00,16,03,16,00,17,17,17,17,16,
16,11,01,01,17,17,01,17,17,17,17,17,17,17,17,17,17,17,17,17,17,01,17,17,17,01,17,17,17,17,17,17,17,17,01,17,17,17,16,
16,11,01,01,17,17,01,17,17,17,17,17,01,17,17,17,17,17,01,17,17,01,17,17,17,01,01,01,01,17,17,17,17,17,01,17,17,17,16,
16,13,17,17,17,17,17,17,17,17,17,17,17,17,17,17,17,17,17,17,17,17,17,17,17,17,01,01,01,01,17,17,01,01,01,17,17,13,16,
16,11,07,07,11,11,11,11,11,11,11,11,11,11,11,11,11,11,11,13,13,11,11,11,11,11,11,11,11,11,11,11,11,11,11,11,11,11,16,
16,03,05,05,05,05,05,05,05,05,05,03,03,03,05,03,03,05,03,13,13,03,05,05,03,03,05,03,03,03,05,03,03,05,03,03,03,03,16,
14,15,15,15,15,15,15,15,15,15,15,15,15,15,15,15,15,15,15,15,15,15,15,15,15,15,15,15,15,15,15,15,15,15,15,15,15,15,15,

2,2,2,2,2,2,2,2,2,2,2,2,2,2,2,2,2,2,2,2,2,2,2,2,2,2,2,2,2,2,2,2,2,2,2,2,2,2,2,
2,0,0,0,0,0,0,0,0,0,0,0,0,0,0,0,0,0,0,2,2,0,0,0,0,0,0,0,0,0,0,0,0,0,0,0,0,0,2,
2,0,0,0,0,0,0,0,0,0,0,0,0,0,0,0,0,0,0,2,2,0,0,0,0,0,0,0,0,0,0,0,0,0,0,0,0,0,2,
2,2,0,0,0,0,0,0,0,0,2,0,0,0,0,0,0,0,0,0,0,0,0,0,0,0,0,2,0,0,0,0,0,0,0,0,0,2,2,
2,0,0,0,0,0,0,0,0,0,0,0,0,0,0,0,0,0,0,0,0,0,0,0,0,0,0,0,0,2,2,2,0,0,0,0,0,0,2,
2,0,0,0,0,0,0,0,0,0,0,0,0,0,0,0,0,0,0,0,0,0,0,0,0,0,0,0,0,2,2,2,0,0,0,0,0,0,2,
2,0,0,0,0,0,0,0,0,0,0,0,0,0,0,0,0,0,0,0,0,0,0,0,0,0,0,0,0,0,0,0,0,0,0,0,0,0,2,
2,0,0,0,0,0,2,2,2,0,0,0,0,2,2,2,0,0,0,0,0,0,0,2,0,0,0,0,0,0,2,2,2,0,0,0,0,0,2,
2,0,0,0,0,0,2,0,2,0,0,0,0,2,0,0,0,0,0,0,0,0,2,2,2,0,0,0,0,0,2,0,2,0,0,0,0,0,2,
2,0,0,0,0,0,2,2,2,0,0,0,0,2,2,2,0,0,0,0,0,0,2,2,2,0,0,0,0,0,2,0,2,0,0,0,0,0,2,
2,0,0,0,0,0,2,2,0,0,0,0,0,2,2,2,0,0,0,0,0,0,2,2,2,0,0,0,0,0,2,0,2,0,0,0,0,0,2,
2,0,0,0,0,0,2,0,2,0,0,0,0,2,2,2,0,0,0,0,0,0,2,2,2,0,0,0,0,0,2,2,2,0,0,0,0,0,2,
2,0,0,0,0,0,2,2,2,0,0,0,0,2,0,0,0,0,0,0,0,0,2,2,2,0,0,0,0,0,2,0,2,0,0,0,0,0,2,
2,0,0,0,0,0,2,2,2,0,0,0,0,2,0,0,0,0,0,0,0,0,2,2,2,0,0,0,0,0,2,0,2,0,0,0,0,0,2,
2,0,0,0,0,0,2,2,2,0,0,0,0,2,0,0,0,0,0,0,0,0,2,2,2,0,0,0,0,0,2,0,2,0,0,0,0,0,2,
2,0,0,0,0,0,2,2,2,0,0,0,0,2,0,0,0,0,0,0,0,0,2,0,2,0,0,0,0,0,2,0,2,0,0,0,0,0,2,
2,0,0,0,0,0,2,2,0,0,0,0,0,2,2,2,0,0,0,0,0,0,2,0,2,0,0,0,0,0,2,0,2,0,0,0,0,0,2,
2,0,0,0,0,0,0,0,0,0,0,0,0,0,0,0,0,0,0,0,0,0,0,0,0,0,0,0,0,0,0,0,0,0,0,0,0,0,2,
2,0,0,0,0,0,0,0,0,0,0,0,0,0,0,0,0,0,0,0,0,0,0,0,0,0,0,0,0,0,0,0,0,0,0,0,0,0,2,
2,2,0,0,0,0,0,0,0,0,0,0,0,0,0,0,0,0,0,0,0,0,0,0,0,0,0,0,0,0,0,0,0,0,0,0,0,2,2,
2,0,0,0,0,0,0,0,0,0,0,0,0,0,0,0,0,0,0,2,2,0,0,0,0,0,0,0,0,0,0,0,0,0,0,0,0,0,2,
2,0,0,0,0,0,0,0,0,0,0,0,0,0,0,0,0,0,0,2,2,0,0,0,0,0,0,0,0,0,0,0,0,0,0,0,0,0,2,
2,2,2,2,2,2,2,2,2,2,2,2,2,2,2,2,2,2,2,2,2,2,2,2,2,2,2,2,2,2,2,2,2,2,2,2,2,2,2,

